0000000000000000000000000000
0111111111111001111111111110
0100001000001001000001000010
0300001000001001000001000030
0100001000001001000001000010
0111111111111111111111111110
0100001001000000001001000010
0100001001000000001001000010
0111111001111001111001111110
0000001000002002000001000000
0000001000002002000001000000
0000001002222222222001000000
0000001002000220002001000000
0000001002000220002001000000
2222221222000220002221222222
0000001002000000002001000000
0000001002000000002001000000
0000001002222222222001000000
0000001002000000002001000000
0000001002000000002001000000
0111111111111001111111111110
0100001000001001000001000010
0100001000001001000001000010
0311001111111111111111001130
0001001001000000001001001000
0001001001000000001001001000
0111111001111001111001111110
0100000000001001000000000010
0100000000001001000000000010
0111111111111111111111111110
0000000000000000000000000000